NO ./path_to_the_north_texture 
SO ./path_to_the_south_texture
WE ./path_to_the_west_texture 
EA ./path_to_the_east_texture

                 
F 220,100,0
C 205,30,0

              
 1111
 11111111111111111
 10000000000001111
 1000000S000000001
 10000000000000001
 1111111111111111111111